1111111111111111111111111111111111111111111111111111111111111111
1111110000001000000000000000100000000000000000100000000000000001
1000000000001000000000000000100000000000000000100000000000000001
1111110000001000000000000000100000000000000000100000000000000001
1000000000001111111110001111111111111111000111111111111100000001
1111110000000000000000000000000000000000000000000000000000000001
1000000000000000000000000000000000000000000000000000000000000001
11111000000
10000000000
11111000000
10000000000
11111000000
10000000000
11111011110
10000011110
11111011110
10000011110
11111010000
10000010000
11111010000
10000000000
11111111
10000000
10000001
10000001
11111111
1
1
1
11111111
1
1
1
11111111
1
1
1
11111111
100001
100000000000000000000000000000000000000000000000001111111111111101
100001000000000000000000000000000000000000000000000000000000000001
111111000000000000000000000000000000000000000000001111111111111101
111111111110000000100000000000000000000000000000000000000000000001
100000000000000000111111111111111000000000000000000111111111111101
100000000000000000100000000000000000000000000000000000000000000001
100000000000000000111111111111111000000000000000000111111111111101
100000000000000000100000000000000000000000000000000000000000000001
100000000000000000111111111111111000000000000000000111111111111101
100000000000000000100000000000000000000000000000000000000000000001
100000000000000000111111111111111000000000000000000111111111111101
111111111111111111111111111111111111111111111111111111111111111111