1111111
10EC0C1
11P0110
1111111
