111111111111111111111
1110000C0000000000001
11111000P00111110E001
111111111111111111111
