111111111
10ECC1001
11P011001
111111111