1111111
10EC0C1
11P0111
1111111
