11111111111111111111111111111111111111111111111
111111000000000000000000000000C0000011110001011
111111111111111111111100000000000000CCC00000001
111000000000000P000000000000000E000000000000001
11111111000000000000000C0000000000000000C000001
1110000000000000000C000000000000C00000000000001
10000000000000000000000000000000000011111111101
11111111111111000000000000010101010000000001001
11111111111111111111111111111111111111111111111