11111111111111111111111111111111111111111111111111111111111
1111110000000000000000000000CC00000000000000C00000111100011
111111111111111111111100000000000000CCC000000000CCCC00000C1
111000000000000P000000000000000E0000000000000000000C0000001
11111111000000000000000C0000000000000000C00000C0C0000000001
1110000000000000000C000000000000C00000000000000010101011111
1000000000000000000000000000000000001111111110000000C000001
11111111111111000000000000010101010000000001000010000C00001
11111111111111111111111111111111111111111111111111111111111