1111111111111111111111111111111111111111111111111111111111111111111111
1111111111111111111111111111111111111111111111111111111111111111111111
1111111111111111111111111111111111111111111111111111111111111111111111
1111111111111111111111111111111111111111111111111111111111111111111111
1111110000000000000000000000CC00000000000000C0000011110001011111111111
111111111111111111111100000000000000CCC000000000CCCC00000CC01111111111
111000000000000P000000000000000E0000000000000000000C000000001111111111
11111111000000000000000C0000000000000000C00000C0C000000000001111111111
1110000000000000000C000000000000C0000000000000001010101111111111111111
1000000000000000000000000000000000001111111110000000C00000011111111111
11111111111111000000000000010101010000000001000010000C0000001111111111
1111111111111111111111111111111111111111111111111111111111111111111111
1111111111111111111111111111111111111111111111111111111111111111111111
1111111111111111111111111111111111111111111111111111111111111111111111
1111111111111111111111111111111111111111111111111111111111111111111111