111111111111111111111
111000000C00001100001
1110000P000E011000011
11100000011C111000001
110000001110000011101
1111CC11100011C111111
111111111111111111111