111111111111111111111111111111111111111111111111111111111111111111111111111111
100000000000000000000000000000000000000000000000000000000000000000000000000001
100000000000000000000000000000000000000000000000000000000000000000000000000001
100000000000000000000000000000000000001100000000000000000000000000000000000001
100011111111111111111111111111111111111100011111111111111111111111111111111111
100010000000000000000010000000000000001100010000000000000000010000000000000001
100010000C00000000000010000000000000001100010000C00000000000010000000000000001
100010000000000000000011011111111111111100010000000000000000011011111111111111
100010000000000000000000000000000000CC1100010000000000000000000000000000000CC1
10C010000000011111111011001111111000CC1100010000000011111111111001111111000CC1
10001000000001000C00000100000C001000CC110C010000000011111111011001111111000CC1
100010000000011111111111001111111000CC1100010000000011111111111001111111000CC1
1000100000000E0000P00000000001000000CC1100000000000011111111111001111111111111
100000000000011111111111001111111111111100000000000011111111111001111111111111
100010000000000000100000000000000000001100010000000000000100000000000000000001
100010000000011111111111001000000000001100010000000011111111111001000000000001
100010000000000000000000001000000000001100010000000000000000000001000000000001
100010000000000000000000000000000000001100010000000000000000000000000000000001
100011111001111100111110011100000000001100011111001111100111110011100000000001
100010000000010000001000000100000000001100010000000010000001000000100000000001
10001010C0000100C000100C00010000000000110001010C0000100C000100C000100000000001
111111111111111111111111111111111111111111111111111111111111111111111111111111