11111111111111111111111111111111111111111111111111111111111
1111110000C000XE000000X000000000000X00000000000000111100011
11111111111111111111110000000000000000000000000000000000001
111000000000000P000000X000000000C0000000000000000C000000001
1111111100000000000000000000C000000000000000000000000000001
11100000000000000000000000000000000000000000000010101011111
10000C0C0000000C00000000C0000000X00011111111100000000000011
11111111111111000000000000010101010000000001000010000000101
1111110000C000X0000000X000000000000X00000000000000111100011
11111111111111111111110000000000000000000000000000000000001
1110000000000000000000X000000000C0000000000000000C000000001
1111111100000000000000000000C000000000000000000000000000001
11100000000000000000000000000000000000000000000010101011111
10000C0C0000000C00000000C0000000X00011111111100000000000011
11111111111111000000000000010101010000000001000010000000101
1110000000000000000000X000000000C0000000000000000C000000001
1111111100000000000000000000C000000000000000000000000000001
11100000000000000000000000000000000000000000000010101011111
10000C0C0000000C00000000C0000000X00011111111100000000000011
11111111111111000000000000010101010000000001000010000000101
1110000000000000000000X000000000C0000000000000000C000000001
1111111100000000000000000000C000000000000000000000000000001
11100000000000000000000000000000000000000000000010101011111
10000C0C0000000C00000000C0000000X00011111111100000000000011
11111111111111000000000000010101010000000001000010000000101
11111111111111111111111111111111111111111111111111111111111