1111111111
1000000001
10ECC00X01
110X110001
1000000001
1000000001
100000X001
1000X00001
1000000001
10X0000001
1000000001
1000X00001
1000000001
10000X0001
1000000001
1000000001
1000X00001
1000000001
1000X00001
1000000001
1000000001
100X000001
1000000001
10000000X1
1000000001
10000X0001
1000000001
10X0000001
1000000001
10000000P1
1111111111
