11111111111111111111111111111111111111111111111111111111111
1111110000C0000E0000000000000000000000000000000000111100011
11111111111111111111110000000000000000000000000000000000001
111000000000000P0000000000000000C0000000000000000C000000001
1111111100000000000000000000C000000000000000000000000000001
11100000000000000000000000000000000000000000000010101011111
1000000C0000000C00000000C0000000000011111111100000000000011
11111111111111000000000000010101010000000001000010000000101
11111111111111111111111111111111111111111111111111111111111
