1111111111
1000000001
10ECC00X01
11PX110001
1111111111
