1111111111
1000000001
10ECC00X01
110X110001
100000X001
1000X00001
10X0000001
1000000001
10X0000001
1000000001
1000000XP1
1111111111
