1111111111
10ECC0XX11
111P100001
1111111111
