1111111111111
10010C00C00C1
1XX0011111001
1P0C11EC0X001
1111111111111
