1111111
1P00E01
1111111
100C001
1111111
