1111111
1P0C001
1111111
100E001
1111111
