1111111111111
10010C00C00C1
1C00011111001
1P0C11EC0C001
1111111111111
